tttttttttttttttt
tggggggggggggggt
tggggggggggggggt
tggggggggggggggt
tggggggggggggggg
tggggggggggggggg
tggggggggggggggg
tggggggggggggggt
tggggggggggggggt
tggggggggggggggt
tttttttttttttttt