bbbbbbbbbbbbbbbbb
bcccccccccccccccb
bcccccccccccccccb
bcccccccccccccccc
bcccccccccccccccc
bcccccccccccccccc
bcccccccccccccccb
bcccccccccccccccb
bcccccccccccccccb
bbbbbbbbbbbbbbbbb