bbbbbbbbbbbbbbbb
bssssssssssssspb
bsssssssssssssgb
bssssssssssssssb
ssssssssssssssob
sssssssssssssstb
ssssssssssssssbb
bssssssssssssseb
bssssssssssssswb
bsssssssssssssxb
bbbbbbbbbbbbbbbb