ttttttttttttttttt
tgggggggggggggggt
tgggggggggggggggt
ggggggbgcgbgggggg
cccccccccgggggggg
ggggggggggggggggg
tgggggggggggggggt
tgggggggggggggggt
tgggggggggggggggt
tttttttgggttttttt