tttttttggttttttt
tttttttggttttttt
gggggggggggggggt
tgtgggtggtgtgggt
gggggggggggggggg
tgtgtgtggtgtgtgg
gggggggggggggggg
tgtgggtggtgtgggt
gggggggggggggggt
tttgtgtggtgtgtgt
tttgtgtggtgtgtgt