zzzzzzzzzzzzzzmz
zzzzzzzzzzzzzzmz
zzzzzzzzzzzzzzmz
zzzzzzzzzzzzzzmz
zzzzzzzzzzzzzzmz
zzxxxxxxxxxxxxxz
zzxxxxxxxxxxxxxz
zzxxxxxxxxxxxxxz
zzxxxxxxxxxxxxxz
zzxxxxxxxxxxxxzz
zzxxxxxxxxxxxxzz