wwwwwwwwwwwwwwmw
wwwwwwwwwwwwwwmw
wwwwwwwwwwwwwwmw
wwwwwwwwwwwwwwmw
wwwwwwwwwwwwwwmw
wwxxxxxxxxxxxxxw
wwxxxxxxxxxxxxxw
wwxxxxxxxxxxxxxw
wwxxxxxxxxxxxxxw
wwxxxxxxxxxxxxww
wwxxxxxxxxxxxxww