tttttttttttttttt
tttttttttttttttt
tttggggggggggggg
tttggggggggggggg
gggggggggggggtgg
gggggggggggggggg
eeeeeeeggggggtgg
eeeeeeeggggggggg
eeeeeeeggggggggg
eeeeeeeggggtttgt
eeeeeeeggggtttgt