tgtgggtgtgttggtt
tgtgggtgtgttggtt
gggggggggggggggg
ggggggggggtggggt
ggtgggtgtggggggt
ggggggggggtggggt
ggtgggtgtggggggt
ggggggggggtggggt
gggggggggggggggg
tgtgggtgtgttggtt
tgtgggtgtgttggtt