tttttttttttttttt
tttttttttttttttt
gggggggggggggttt
ttttttttttttgttt
ttttttttttttgggg
ttttttttttttgggg
ttttttttttttgggg
ttttttttttttgttt
gggggtttttttgttt
ttttgtttttttgttt
ttttgtttttttgttt