tttgttttttttgttt
tttgttttttttgttt
tttgttttttttgttt
tttgttttttttgttt
gggggggggggggggg
gggggggggggggggg
gggggggggggggggg
tttgttttttttgttt
tttgttttttttgttt
tttgttttttttgttt
tttgttttttttgttt