rrrrrrrrrrrrrrrr
rrrrrrr rrrrrrrr
rrggggggrrrrggrr
rggggggggrrggggr
ggggtgggggggtggr
gggggggggggggggr
ggggtgggggggtggr
rggggggggrrggggr
rrggggggrrrrggrr
rrrrrrrrrrrrrrrr
rrrrrrrrrrrrrrrr