qqqqqggggeeeeeee
qqqqqggggeeeeeee
qqqqgggggeeeeeee
qqqqgggggeeeeeee
qqqqgggggeeeeeee
qqqggggggepepeee
qqgggggggeeeeeee
qqgggggggeeeeeee
qqqggggggeeeeeee
qqqqqggggeeeeeee
qqqqqggggeeeeeee