oooooooooooooooo
oooooooooooooooo
ooggggggggggoooo
ogggggggggggoooo
oggogogogogggggg
oggggggggggggggg
oggogogog gggggg
ogggggggggggoooo
ooggggggggggoooo
ooooooooooggoooo
ooooooooooggoooo