oooooooggooooooo
oooooooggooooooo
oogggggggggggggg
ooggoooooooooooo
ggggoooooooooooo
ggggoooooooooooo
ggggoooooooooooo
ooggoooooooooooo
oogggggggggggggg
oooooggoogggggoo
oooooggoogggggoo