oooooooggooooooo
oooooooggooooooo
ggggggggggggggoo
oogggggggggggggo
ooggggtggggggggg
ooggggggggtggggg
ooggggtggggggggg
oogggggggggggggo
ggggggggggggggoo
ooooggogggogogoo
ooooggogggogogoo