tttttttggeeeeeee
tttttttggeeeeeee
ttgggggggeeeeeee
ttgggtgggeeeeeee
gggggggggeeeeeee
gggggtgggggggggg
ggggggggggggggtt
ttgggtggggggggtt
ttggggggggggggtt
tttggttttggttgtt
tttggttttggttgtt