eeeeeeeeeeeeeeee
eeeeeeeeeeeeeeee
eeeeeeeeeeeeeeee
eeeeeeeeeeeeeeee
eeeeeeeepeeeeeee
gggggeeggggggggg
ttgggeegggggggtt
ttgggeegggggggtt
ttgggeegggggggtt
ttgggeegggtgtgtt
ttgggeegggtgtgtt