eeeeeeeggttttttt
eeeeeeeggttttttt
eeeeeeeggggggggg
eeeeeeeggggggggg
eeeeeeegggtgttgg
gggggggggggggggg
tttggggggg gttgg
tttggggggggggggg
tttggggggggggggg
tttttttttttttttt
tttttttttttttttt