tttttttttttttttt
tttttttttttttttt
gggggggggggggggg
gggggggtgtgggtgt
gggggggggggggggg
gggtgtgtgtgtgtgt
gggggggggggggggg
gggggggtgtgggtgt
gggggggggggggggg
tttttttttttttttt
tttttttttttttttt