tttttttggttttttt
tttttttggttttttt
tttttttggttttttt
tttttttggttttttt
gggggggggggggggg
gggggggggggggggg
gggggggggeeeeeee
tttttttggeeeeeee
tttttttggeeeeeee
tttttttggeeeeeee
tttttttggeeeeeee