ooggggggggggggoo
ooggggggggggggoo
ooggggggggggggoo
oogggggggggggggo
oogggggggggggggg
oogggggggggggggg
oogggggggggggggg
oogggggggggggggo
ooggggggggggggoo
oooooooooooooooo
oooooooooooooooo