eeeeeeeggggtttgt
eeeeeeeggggtttgt
eeeeeeeggggggggg
eeeeeeeggggggggg
eeeeeeegggggtggg
gggggggggggggggg
gggggggggggg ggg
gggggggggggggggg
gggggggggggggggg
tttttttttttttttt
tttttttttttttttt