tgtgggtgtgttgttt
tgtgggtgtgttgttt
ggggggggggggggtt
ggggggggggtggggt
ggtgggtgtggggggg
ggggggggggtggggg
ggtgggtg ggggggg
ggggggggggtggggt
ggggggggggggggtt
ttttttttttttggtt
ttttttttttttggtt