ttttgtttttttgttt
ttttgtttttttgttt
ttttgttggggggggg
ttttgtgggggggttt
gggggtgggggggttt
gggggtgggggggttt
gggggtgggggggttt
ttttttgggggggttt
tttttttggggggggg
tttttttttttttttt
tttttttttttttttt