tttgttttttttgttt
tttgttttttttgttt
gggggggggg ggggg
ttggttttttttgttt
ttggttttttttgggg
ttggttttttttgggg
ttggttttttttgggg
ttggtttttttttttt
ggggtttttttttttt
tttttttttttttttt
tttttttttttttttt