tttttttttttttttt
tttttttttttttttt
ttgggggggggggggg
tggtttgggggggggg
ggggggggggttttgg
gggtttgttggggggg
ggggggggggttttgg
tggtttgggggggggg
ttgggggggggggggg
tttttttttttttttt
tttttttttttttttt