oooooggggeeeeeee
ooo oggggeeeeeee
gggggggggeeeeeee
gggggggggeeeeeee
gggggggggeeeeeee
gggggggggeeeeeee
gggggggggeeeeeee
gggggggggeeeeeee
gggggggggeeeeeee
oooooggggeeeeeee
oooooggggeeeeeee