ooooooooooggoooo
ooooooooooggoooo
ooooooooooggoooo
ooooooooooggoooo
gggggggggggggggg
gggggggggggggggg
gggggggggggggggg
ooooooooooggoooo
ooooooooooggoooo
ooooooooooggoooo
ooooooooooggoooo