oooooggoogggggoo
oooooggoogggggoo
oooooggg gggggoo
ooooogggoggggggg
ggggggggoggggggg
ggggggggoggggggg
ggggggggoggggggg
ooooooggoooooogg
ooooooggoooooooo
ooooooggoooooooo
ooooooggoooooooo