ooooggogggogogoo
ooooggogggogogoo
ooggggggggggggoo
gggoggggggoggggo
gggggggogggggggg
gggoggggggogoggg
gggggg ggggggggg
gggoggggggoggggo
ooggggggggggggoo
ooooooogggogogoo
ooooooogggogogoo