tttggttttggttgtt
tttggtt tggttgtt
tttggggggggggggg
ttgggggggggggggg
ggggggtggggggggg
gggggggggggggggg
ggggggtggggggggg
ttgggggggggggggg
tttggggggggggggg
tttttttttttttttt
tttttttttttttttt