ttgggeegggtgtgtt
ttgggeegggtgtgtt
gggggeeggggggggg
gggggeegggoggggg
gggggeegggggoggg
gggggppgggoggggg
gggggeegggggoggg
gggggeegggoggggg
gggggeeggggggggg
ttttgeettttttttt
ttttgeettttttttt