tttttttttttttttt
ttttttt tttttttt
ggggggggggggggtt
gggooooggggggggt
ggggggggoooggggg
gggooooggggggggg
ggggggggoooggggg
gggooooggggggggt
ggggggggggggggtt
ttttttttttttggtt
ttttttttttttggtt