tttttttttttttttt
ttttttt tttttttt
ggggggggggggggtt
gggttttggggggggt
ggggggggtttggggg
gggttttggggggggg
ggggggggtttggggg
gggttttggggggggt
ggggggggggggggtt
ttttttttttttggtt
ttttttttttttggtt