tttttttttttttttt
ttttttt tttttttt
ttgggggggttgggtt
tggtgtggggggtggt
gggggggggggggggg
gggtgtggggggtggg
gggggggggggggggg
tggtgtggggggtggt
ttgggggggttgggtt
tttttttggttttttt
tttttttggttttttt