rrrrrrrrrrrrrrrr
rrrrrrr rrrrrrrr
rrgggggggrrgggrr
rggtgtggggggtggr
gggggggggggggggg
gggtgtggggggtggg
gggggggggggggggg
rggtgtggggggtggr
rrgggggggrrgggrr
rrrrrrrggrrrrrrr
rrrrrrrggrrrrrrr