tttgtgtggtgtgtgt
tttgtgtggtgtgtgt
ttgggggggggggggt
tgggtggggtgggtgt
ggtggggggggggggg
ggggtgtggtgtgtgg
gg ggggggggggggg
tgggtggggtgggtgt
ttgggggggggggggt
tttgtgtggtgtgtgt
tttgtgtggtgtgtgt