tttttttggeeeeeee
tttttttggeeeeeee
ttgggggggeeeeeee
tggggtgggeeeeeee
ggtggggggeeeeeee
gggggtgggggggggg
ggtggggggggggggg
tggggtgggggggggg
ttgggggggggggggg
tttttttttttttttt
tttttttttttttttt