oooooooooooooooo
ooooooooooo oooo
oooogggggggggggg
oooggooggooggggg
oogggooggooggggg
oggggggggggggggg
ooggggooggoogggg
ooogggooggoogggg
oooogggggggggggg
oooooooooooooooo
oooooooooooooooo