oooooooooooooooo
oooooooooooooooo
oooooooggooooooo
ooooggggggoooooo
ooogggggggoooooo
gggggggggggggggg
ooogggggggoooooo
ooooggggggoooooo
oooooooggooooooo
oooooooooooooooo
oooooooooooooooo