ooooooooooogggoo
ooooooooo ogggoo
oooooooggggggggg
oooooogggggggggg
oooooggggggggggg
gggggggggggggggg
oooooggeeeeeeeee
oooooogeeeeeeeee
oooooooeeeeeeeee
oooooooeeeeeeeee
oooooooeeeeeeeee