oooooooooooooooo
oooooo ooooooooo
gggggggggggggggg
gggggggggggggggg
gggggggggggggggg
gggggggggggggggg
eeeeeeeeeeeeeeee
eeeeeeeeeeeeeeee
eeeeeeeeeeeeeeee
eeeeeeeeeeeeeeee
eeeeeeeeeeeeeeee