oooooooooooooooo
oooooooooooooooo
ggoooooooooooooo
ggoooooooooooooo
gggggggggggggggg
gggggggggggggggg
eeeeeeeeeeeeeeee
eeeeeeeeeeeeeeee
eeeeeeeeeeeeeeee
eeeeeeeeeeeeeeee
eeeeeeeeeeeeeeee