oooooggggeeeeeee
oooooggggeeeeeee
oooooggggeeeeeee
oooooggggeeeeeee
gggggggggeeeeeee
gggggggggeeeeeee
eeeeeeeeeeeeeeee
eeeeeeeeeeeeeeee
eeeeeeeeeeeeeeee
eeeeeeeeeeeeeeee
eeeeeeeeeeeeeeee