ooooooooooggoooo
ooooo ooooggoooo
gggggggggggggooo
ggggggggggggggoo
gggggggggggggggg
gggggggggggggggg
gggggggggggggggg
ggggggggggggggoo
gggggggggggggooo
oooooooooooooooo
oooooooooooooooo