ooooooggoooooooo
ooooooggoooooooo
oooooogggggggggg
oooooooooooooooo
ggoooooooooooooo
ggggggoooooooooo
ggggggoooooooooo
ooggggoooooooooo
oogggggggggggggg
oooooooooooooooo
oooooooooooooooo