ooooooggggogogoo
ooooooggggogogoo
ggggggggggggggoo
oooooogggggggggo
oooooogggggggggg
ooooooggggoggggg
oooooogggggggggg
oooooogggggggggo
ggggggggggggggoo
oooooooooooooooo
oooooooooooooooo