tttttttttttttttt
tttttttttttttttt
ttggggggggggggtt
tgggggtttggggggt
gggtgtt ttgtgggt
gggggggggggggggt
gggtgtgggtgtgggt
tggggggggggggggt
ttggggggggggggtt
tttttttttttttttt
tttttttttttttttt