ttttgeettttttttt
tt tgeettttttttt
ttgggeeggggggggg
tggggeegtgggtggg
tggggeegggtggggg
tggtgeegtgggtggg
tggggeegggtggggg
tggggeegtgggtggg
ttgggeeggggggggg
ttttteettttttttt
ttttteettttttttt