rrrrrrrrrrrrggrr
rrrrrr rrrrrggrr
ggggggggggggggrr
ggggggggtgggggrr
ggggggggggtggggr
ggtggtggtggggggg
ggggggggggtggggr
ggggggggtgggggrr
ggggggggggggggrr
rrrrrrrrrrrrrrrr
rrrrrrrrrrrrrrrr