tttttttttttttttt
tggggggggggggggt
tggggggggggggggt
tggggggggggggggt
tggggggggggggggt
gggggggggggggggg
tggggggggggggggt
tggggggggggggggt
tggggggggggggggt
tggggggggggggggt
tttttttggttttttt