rrrrrrrggrrrrrrr
rrrrr rggrrrrrrr
rrrrgggggrrrrrrr
rrrggggggrrrrrrr
rrgggggggrrrrrrr
gggggggggggggggg
rrggggggggggggrr
rrggggggggggggrr
rrggggggggggggrr
rrrrrrrrrrrrrrrr
rrrrrrrrrrrrrrrr