tttttttggttttttt
ttttt tggttttttt
ttttgggggttttttt
tttggggggttttttt
ttgggggggttttttt
gggggggggggggggg
ttggggggggggggtt
ttggggggggggggtt
ttggggggggggggtt
tttttttttttttttt
tttttttttttttttt