tttgtgtggtgtgtgt
tttgtgtggtgtgtgt
ttgggggggggggggg
ttggggtggtgtgtgg
tgtgtggggggggggg
ggggggtggtgtgtgg
tgtg ggggggggggg
ttggggtggtgtgtgg
ttgggggggggggggg
tttttttttttttttt
tttttttttttttttt