oooooooooooooooo
oooooooooooooooo
goooooggggggoooo
ggoooogggggggooo
gggooogggogggooo
ggggooggo oggggg
gggggggggogggooo
gggggggggggggooo
ggggooggggggoooo
oooooooooooooooo
oooooooooooooooo