bbbbbbbbbbbbbbbbb
bcccccccccccccccb
bcccccccccccccccb
ccccccccccccccccb
ccccccccccccccccb
ccccccccccccccccb
bcccccccccccccccb
bcccccccccccccccb
bcccccccccccccccb
bbbbbbbcccbbbbbbb