ttttttttttttttttt
tgggggggggggggggt
tgggggggggggggggt
ggggggbgcgbgggggt
cccccccccgggggggt
ggggggggggggggggt
tgggggggggggggggt
tgggggggggggggggt
tgggggggggggggggt
tttttttgggttttttt