tttttttttttttttt
tggggggggggggggt
tggggggggggggggt
tggggggggggggggt
tggggggggggggggt
tggggggggggggggt
tggggggggggggggt
tggggggggggggggt
tggggggggggggggt
tttttttttttttttt