ttttttttttttttttt
tgggggggggggggggt
tgggggggggggggggt
tggggbbbggggggggt
tgggggggggggggggt
tgggggggcccgggggt
tgggggggggggggggt
tgggggggggggggggt
tgggggggggggggggt
ttttttttttttttttt