tttttttgggttttttt
tgggggggggggggggt
tgggggggggggggggt
ggggggggggggggggg
ggggggggggggggggg
ggggggggggggggggg
tgggggggggggggggt
tgggggggggggggggt
tgggggggggggggggt
tttttttgggttttttt