tttttttgggttttttt
tgggggggggggggggt
tgggggggggggggggt
tgggggggggggggggg
tgggggggggggggggg
tgggggggggggggggg
tgggggggggggggggt
tgggggggggggggggt
tgggggggggggggggt
ttttttttttttttttt