tttttttgggttttttt
tgggggggggggggggt
tgggggggggggggggt
ggggggggggggggggt
ggggggggggggggggt
ggggggggggggggggt
tgggggggggggggggt
tgggggggggggggggt
tgggggggggggggggt
ttttttttttttttttt