tttttggttttttttt
ttggggggggggggtt
ttttgggggggggttt
tttttttggggggttt
ttgggggggggggttt
ttttggggtttttttt
tttggggggggggggg
tttttttttggggggg
ttttggggggggtttt
ttttggggggggggtt
ttttttggggggtttt
ttttttggtttttttt