ttttttttttttggtt
tttttt tttttggtt
ggggggggggggggtt
ggggggggtgggggtt
ggggggggggtggggt
ggtggtggtggggggg
ggggggggggtggggt
ggggggggtgggggtt
ggggggggggggggtt
tttttttttttttttt
tttttttttttttttt